E E E E E E E E E E E E E E E E E E E E E E E E E E E E E E E E
E 0 A A A A A A A A A A A A A A A A A A A A A A A A A A A A A E
E E E E E E E E 1 A A A A A A A A A A A A A A A A A A A A A A E
E E E A E A A E E E E E E E E E A A A A A A A A A A A A A A A E
E A A A A A A A A A A A A A E E E A A A A A A A A A A E A A A E
E A A A A A A A A A A A A A E E E E A A A A A A A A E A A A A E
E A E E E E E E A E E E A E E E E E W F W W W W W W E E E A A E
E F E E E E W E W W E W W W W E E E W F F W W W W W E 3 W 4 F E
E F E E E E W W W W W W E E W E E E W W F F F W W E E W E E F E
E F F E E E E E E E E E E E W E E E W W W W F F W E E W W E F E
E F F E E E E A A A E E E E W E W E E E 2 W E E E E E W W E F E
E F F E E E E A A A A A E E W E W E E E W W W W W W W W W E F E
E F E E E E A A 3 E E W W E W W W E E E W W E W W E E W W E F E
E F E E E E E E E E E E W W W W W E W W W W W W W W E W W E F E
E F F E E E E E F F E E E E W E W W W W W W W W W W E W E E F E
E F F F E E E F F F F F F F F F F F F F F F F F F F E E E E F E
E F F F F F F F F F F F F F F F F F F F F F F F F F F F F F F E
E E E E E E E E E E E E E E E E E E E E E E E E E E E E E E E E